+-+-+-+-+-+-+-+-+-+-+-+-+-+-+-+-+-+-+-+-+
|   |         |   |   | |   |     |     |
+-+ +-+-+ + +-+ +-+-+ + +-+ + +-+-+ + +-+
|     | | |     | |     | |       | |   |
+ +-+-+ + + +-+-+ +-+ +-+ + + + +-+-+ +-+
| |   | | |   |         | | | | | |     |
+ +-+ + +-+-+ + +-+ +-+-+ +-+ +-+ + + +-+
| | |       |     |   | | |         |   |
+ + + + +-+-+ + +-+-+-+ + + + + + + +-+-+
| |   |       | |   |   | | | | | |     |
+ + +-+-+ +-+ +-+-+ +-+ + + + + + +-+-+-+
| |     |   |     | | | |   | | | |     |
+ + +-+-+-+-+-+ +-+ + + +-+-+ + +-+ +-+-+
| | | | |     | | |   | |   | |         |
+ + + + +-+ +-+ + + +-+ + +-+ +-+-+-+-+-+
| |     |         | |   |   | |     |   |
+ + + +-+ +-+ +-+-+ +-+ + +-+ + +-+-+ +-+
|   |   | |   | | |   |       |         |
+-+-+-+ +-+ +-+ + +-+ +-+-+-+ + + +-+ +-+
| |       |     | | |           | | | | |
+ +-+ +-+-+ + +-+ + +-+ + +-+ +-+-+ + + +
| | | |     | | |   | | |   |   | | |   |
+ + +-+-+ + +-+ + +-+ + + + +-+-+ + + +-+
| | |     | |       |   | |   | |   |   |
+ + +-+-+ +-+-+ + +-+-+-+-+-+ + + +-+ +-+
|   | |   |     | | | |   |   | |       |
+-+ + + +-+ + + +-+ + + +-+ +-+ +-+ + +-+
| |         | |   |           |   | |   |
+ + +-+ + + + +-+-+ + +-+-+-+-+-+ + + +-+
| | | | | | |     | |   |     | |   |   |
+ + + +-+-+-+ + +-+ +-+-+ +-+-+ + +-+-+-+
|   | |     | |   |     | |           | |
+-+ + +-+ +-+ + +-+-+-+ + + + +-+ + +-+ +
| | |   |     | |       |   | |   | |   |
+ + + +-+ +-+ +-+ + +-+-+ + +-+ + +-+ +-+
| | |   | |       | | | | | |   | |     |
+ + +-+ +-+-+-+-+-+ + + + +-+-+-+-+ +-+-+
|       |     |   |   | |     | |       |
+ +-+ +-+ +-+-+ +-+-+ + +-+-+ + + +-+-+-+
|   |               |       |           |
+-+-+-+-+-+-+-+-+-+-+-+-+-+-+-+-+-+-+-+-+
