+-+-+-+-+-+-+-+-+-+-+-+-+-+-+-+-+-+-+-+-+-+-+-+-+-+-+-+-+-+-+-+-+-+-+-+-+-+-+-+-+-+-+-+-+-+-+-+-+-+-+
|     | |   | |   | |   | |     | |       | |     | |   | | |           |   | |   |   | | |     | | |
+-+ +-+ +-+ + +-+ + +-+ + + +-+-+ +-+-+-+ + + + +-+ +-+ + + +-+-+ +-+ +-+ +-+ +-+ + +-+ + +-+-+ + + +
| | |   |   | |   | | |   |       | | |   | | |     | | | |         |   |     | | | | | |   | |     |
+ + +-+ + +-+ + +-+ + + +-+ +-+-+-+ + +-+ + +-+ + +-+ + + + +-+-+-+-+ +-+-+ +-+ + + + + +-+ + +-+ +-+
|   |     | |         |   |           | | | | | | | | | | | | |               | | | | |   |   |   | |
+-+ + + +-+ +-+-+ + +-+-+ + + +-+-+-+-+ + + + +-+ + + + + + + + + + +-+-+-+ +-+ + + + +-+ +-+ + +-+ +
| | | |     |     | | | |   | | | |                 | |   | | | | | |     |         |   | |         |
+ + + +-+ +-+-+ +-+-+ + +-+ +-+ + + +-+ + + +-+ + +-+ + +-+ + + +-+-+-+-+ + + +-+-+-+ +-+ +-+-+-+ +-+
|       | | |     | | | |             | | | | | |   | | | | |     |   | | | |         | |   | | | | |
+-+ + + +-+ +-+-+ + + + + + +-+ +-+-+ + +-+-+ + +-+-+ + + +-+ +-+-+ +-+ + + + + + + +-+ +-+ + + + + +
| | | | | | | | |     |   | | | |   | | | |   |     |     | |       |     | | | | | |   | |     | | |
+ + +-+-+ + + + +-+-+ +-+ +-+ + +-+ + +-+ + +-+-+-+ +-+ +-+ +-+-+ +-+ + +-+-+ +-+-+-+-+ + +-+ +-+ + +
| | | | |           | | | |   | | | |   | | |       |     | | |   |   |     | |     |   |   | |   | |
+ + + + +-+ +-+-+ +-+ + + + +-+ + + + +-+ + +-+-+-+ + +-+-+ + +-+ +-+ + + +-+ +-+-+ + +-+ +-+ + +-+ +
| |   | | |   | |   |   | | |       |   | | | | |       | | |       | | | |       |   | | | |   | | |
+ +-+ + + + +-+ + +-+-+ + + +-+ + +-+ +-+ + + + +-+-+ +-+ + +-+-+-+ +-+ +-+-+-+ +-+ +-+ + + + +-+ + +
|   |     | | |   |   |     |   | |   |                     |   |     | | | |     | |       | | |   |
+-+ + +-+-+ + + +-+-+ + +-+-+-+-+ +-+ +-+ +-+-+-+-+-+ + +-+-+ +-+ + +-+ + + +-+ +-+ +-+-+-+ + + +-+ +
|   | | |   | | | |   |     | |   | |   |   |   |     | | |     | |   | |   |   | |   | | | |   | | |
+ +-+ + +-+ + + + +-+ +-+ +-+ +-+ + +-+ + +-+ +-+ + +-+-+ +-+ +-+ + +-+ + +-+ +-+ + +-+ + + + +-+ + +
|   | |   | |     |   | | |     |   | | | | |   | | |       | |   |       |     | | |   |     | |   |
+-+ + + +-+ +-+ +-+ +-+ + +-+ +-+-+ + + +-+ +-+ + +-+ + +-+-+ + +-+ + + +-+ +-+-+ + + +-+-+-+ + +-+ +
| | | |   |   | |   | |     | |       | | | |       | | |   |     | | | |     |   |   |   | |       |
+ + + + +-+ +-+-+-+ + +-+ +-+ +-+ +-+-+-+ + +-+-+-+ + +-+ +-+ + + +-+-+-+ + +-+ +-+ +-+-+ + + + + +-+
| | | |   | |       |       |   |   |   | | | |       |   |   | | | |   | |     |         | | | | | |
+ + + +-+ + + + + +-+ +-+-+-+ +-+-+ +-+ + + + +-+ +-+-+-+ +-+-+ +-+ +-+ + +-+-+-+-+-+ + +-+ + +-+-+ +
|         | | | | |   |         | |   | |   | | |   | | | |       | |     |     | |   |   |     |   |
+-+-+ + +-+ +-+ +-+ +-+-+-+-+-+ + +-+ + + +-+ + + +-+ + + +-+ +-+-+ + +-+-+-+-+ + +-+-+-+ + +-+-+-+ +
| |   | |     |   |   | |   | |       |     | |   | |     |         | |       | |     |   |       | |
+ + + +-+ +-+-+-+ + +-+ + +-+ +-+ + +-+ + +-+ +-+ + +-+-+ + +-+-+-+ +-+-+-+ +-+ + + +-+-+ + +-+-+-+ +
| | | |           | | |       |   | |   |   |     |   |   |       |         | | | |   | | | |       |
+ + +-+ + +-+-+-+-+ + + + +-+-+-+ +-+ +-+-+-+-+ +-+ +-+-+ +-+-+-+ +-+-+ +-+-+ + +-+ +-+ + + + + +-+-+
|   | | |   | |   | |   |     | |         | | |   | | |   |   |       | |     |   | |     | | |   | |
+-+ + + + +-+ + +-+ + + + +-+-+ +-+ +-+ +-+ + + +-+ + + +-+ +-+ +-+ + +-+-+-+ + +-+ + +-+-+ +-+ +-+ +
|   |   |   |   |     | |     |     |   |   |   | | |   | |   | |   |   |   |     |   |   |       | |
+ +-+-+-+ +-+-+ +-+ +-+-+ + + +-+ + + +-+-+ + +-+ + +-+ + +-+ +-+ +-+ +-+ +-+ + +-+ +-+ +-+-+ +-+-+ +
| | |   | |     | | |   | | |   | | |       | |       | | |     | | | | |     | | |   |   | |   | | |
+ + + +-+ + + +-+ + +-+ +-+ + +-+-+ +-+ + + +-+ + +-+-+ + + + +-+ + + + + +-+ +-+ + +-+-+ + + +-+ + +
|   | | |   | | | |   |   | | |       | | |   | | | |   | | | |     |       |   | |   | | | | |     |
+ +-+ + +-+-+ + + + +-+ +-+ +-+-+ + +-+-+ + +-+-+ + +-+ + +-+ + + + +-+-+ +-+-+-+ +-+ + + + + +-+ +-+
| |   |     | | |     | | |   |   | |     | | |   |             | |   | |       |   |             | |
+ +-+ +-+-+ + + + + +-+ + + + +-+ +-+ +-+ +-+ + +-+-+ + +-+-+-+ +-+-+-+ + + + +-+-+ + +-+ + +-+ +-+ +
| |           |   |   |   | | | |   | | | | | | |   | |   |       | |   | | |   |   |   | |   | | | |
+ +-+ +-+-+ +-+-+ + +-+-+ + +-+ + +-+-+ + + + + +-+ + + +-+-+-+-+-+ + +-+-+ + +-+-+ + + +-+-+-+-+ + +
| |   |       |   | |           |   | | |     | |     |     | | | |   |     | |   | | | | | | |     |
+ + + + +-+ +-+-+ + +-+-+-+-+-+-+-+-+ + +-+-+ + + +-+-+ +-+-+ + + + +-+ + + +-+-+ + + +-+ + + + + +-+
| | | |   | |     |   | | | | | | | | |   |   |       |   |   |         | | |   |       |       |   |
+ + + +-+-+-+-+ +-+ +-+ + + + + + + + + +-+ +-+-+ + +-+-+-+ +-+ + + +-+ +-+-+-+ +-+ + +-+ +-+-+-+-+-+
| | |   | |     | | | | |     |   | | |   | | |   | |   |   |   | |   | |     |   | |               |
+ +-+-+ + +-+ +-+ + + + +-+ +-+-+ + + +-+ + + + +-+-+ +-+ +-+-+-+ +-+ +-+-+-+ +-+ + +-+ +-+ +-+ +-+-+
| | |   | | |   |   |   | | |   | | | |     |   | | | |       |   |     |       |   | |   | | | |   |
+ + +-+ + + +-+-+ +-+ +-+ + +-+ + + + +-+ +-+-+ + + + +-+ + +-+-+ +-+-+-+-+-+-+ +-+ + + + +-+ + +-+ +
| |       |         |           | |         | |     | |   |           | |     | |   |   | |         |
+ + +-+ +-+-+-+ +-+-+ +-+-+ + +-+ + + + +-+-+ +-+ +-+ + + + + + +-+ +-+ +-+-+ + +-+ + + +-+ +-+ + +-+
| |   |   | | | |       |   | |   | | |   |       |     | | | |   | | | | |         | | | |   | | | |
+ + + +-+-+ + + +-+-+-+-+ + +-+-+ +-+ +-+-+-+-+-+ + + +-+ + +-+-+-+-+ + + + + + +-+ + +-+ + +-+ +-+ +
|   |       | | | |   | | |   | | |   | |   | |   | |   | | | |     | |     | | | | |     | |       |
+ + + +-+ +-+ + + + +-+ + + +-+ + + +-+ + +-+ +-+ + + + + +-+ +-+-+ + +-+-+ +-+-+ + + +-+-+-+ +-+-+-+
| | | |             | | | |   | |       |         | | | | |           | |   | | |   | | | |   | |   |
+-+-+ + +-+-+ + +-+-+ + +-+ +-+ +-+ +-+-+-+ + +-+ + +-+-+-+ + +-+ +-+-+ + +-+ + +-+-+ + + +-+ + +-+ +
|   | |     | | | | | |       |             | |   |     |   |   | | |     |   | | |     |         | |
+-+ +-+ + + +-+-+ + + +-+ + +-+ + +-+-+-+-+-+ + + +-+ +-+ +-+-+-+-+ +-+-+ +-+ + + +-+ +-+-+ +-+ +-+ +
|   | | | | | |     | |   | | | | | |   |     | | | |     |       |   | | |   | | | | |   | |     | |
+ +-+ + +-+-+ +-+-+ + + +-+-+ +-+ + +-+ + +-+-+-+-+ + +-+-+ +-+-+-+-+ + + + +-+ + + + +-+ +-+ + +-+ +
| |     | | |           | | | | |     | | | |   | |   |   |   | | |     | | | |             | | |   |
+ + + +-+ + +-+ + +-+-+-+ + + + +-+ +-+ + + +-+ + +-+ +-+ +-+ + + + +-+-+ + + +-+-+ + +-+ + +-+-+ +-+
| | | | |     | |   |           |   | |   | | | | | | | |         | |           |   |   | |     |   |
+ + +-+ + + +-+ +-+-+-+ +-+-+ +-+ +-+ +-+ + + + + + + + + +-+-+ +-+ + +-+ + + +-+-+ + + +-+-+-+-+-+ +
|         | |             | | | | |   | | |   |       | |   |     | | |   | |     | | | | | |       |
+ +-+ + + +-+ +-+-+-+-+ +-+ + + + + +-+ + + +-+ +-+-+-+ + + + + +-+ + + +-+-+-+-+ +-+-+-+ + +-+ + +-+
| |   | |   | |   |       | | | | |           | |     | | | | | | | | |   |       |         | | | | |
+ +-+-+ +-+-+ +-+ + + + +-+ + + +-+ +-+ + +-+-+-+-+-+ + + +-+-+-+ + +-+ +-+-+-+-+-+ + +-+-+-+ +-+ + +
|   |     | |     | | | | | | | | | | | |     |                 | |   |     | | | | |       |     | |
+-+ +-+ +-+ +-+-+-+ + +-+ + + + + + + + + +-+-+ +-+ + + + +-+-+-+ + +-+-+-+ + + + +-+-+-+ +-+-+ +-+ +
| | |     | |   | | | |   |         | | | | | |   | | | |   |     |   | |   | | |   |   | |         |
+ +-+ +-+-+ +-+ + + +-+-+ +-+ +-+ +-+ + +-+ + + + +-+ +-+ +-+-+ +-+ +-+ +-+ + + +-+ + +-+ + + + + +-+
| | |   |   | |             |   | | | | | | |   | | |   | | | |           | |     | | |     | | |   |
+ + +-+ +-+ + +-+-+ +-+ + + +-+ +-+ + + + + + + +-+ + + +-+ + + + +-+ +-+-+ + + +-+ + +-+ +-+-+ +-+-+
|   |   | | | |   |   | | | |   |   |         | |   | | |     | | |   |       |   |     | |         |
+-+ + +-+ + + + +-+ + +-+-+-+-+-+-+ +-+-+ + +-+-+ +-+-+ +-+-+ + + + +-+ + +-+-+ +-+ + +-+-+ + +-+-+-+
| |   |     |     | | | | |   | |       | | | | | |   |   |     | | |   |     |   | | |     |       |
+ + +-+ +-+-+ + +-+ +-+ + +-+ + +-+ +-+-+ +-+ + + +-+ + +-+-+-+-+-+ + + +-+-+ + +-+ +-+ + +-+ +-+ +-+
| |   |   |   | | |   |   | | |   | |     | |       | |   |       |   |     | |   |   | |   |   |   |
+ +-+ + +-+ + +-+ + +-+ +-+ + +-+ + +-+ +-+ +-+ +-+-+ +-+ + + + +-+ +-+-+-+-+ + +-+ +-+ + + + + +-+-+
| |   |   | |   | | | |     |       | | | |   | | | |   |   | | |     | |     | |     | | | | |     |
+ + +-+-+ +-+-+ + + + + + +-+-+-+ +-+ + + + +-+ + + + +-+-+ + +-+-+-+ + + + +-+-+-+-+ +-+-+-+ +-+ +-+
| |   | | | | |   |     | |   |       |     | |   | |     | | |       |   |     |   | | |   |   | | |
+ + +-+ + + + +-+ + + + +-+ +-+ + +-+-+-+-+ + +-+ + + +-+-+-+ +-+-+ + + +-+-+ +-+ +-+ + +-+ + +-+-+ +
|         | |   |   | | |     | |     | |         | |     | | | | | | | |     |   | | | |   |   | | |
+ + + + +-+ + +-+-+-+-+ +-+-+ + + +-+-+ +-+-+-+-+ + +-+-+ + + + + + +-+ + +-+-+ +-+ + + + +-+-+ + + +
| | | |     |   | | |     | |   |   |   |     |         |   | | |     | | | | | | | | | | |     |   |
+-+-+-+-+ +-+ +-+ + + + +-+ +-+-+-+ +-+ + + +-+-+ +-+-+-+ +-+ + + +-+-+ +-+ + + + + + + + + +-+-+ +-+
|   | |     |         | | | | | | | |     |     |   |     | | |       |   | | | | |                 |
+ +-+ + + + +-+-+ + +-+-+ + + + + + +-+ + +-+ +-+-+ + + +-+ + + + + + +-+-+ + + + + +-+ +-+ + + +-+-+
| |     | |   | | |       |   |     |   | |   | | |   | | |     | | | | | | | |       | |   | |   | |
+ +-+ +-+ + +-+ + +-+ +-+-+-+ +-+-+ +-+ + +-+-+ + + +-+-+ +-+ +-+-+ +-+ + + + +-+ +-+ +-+ + +-+ +-+ +
| | | |   |   |     |         | | |   | | |   | | | | |     | | | | | | | | |       | | | | |       |
+ + + + +-+ + + + +-+-+ +-+ +-+ + +-+ +-+ + +-+ + + + + +-+-+ + + + + + + + + + +-+-+-+ + + + +-+ +-+
|     |   | | | |     |   |                       |         |     |           |         | | |   |   |
+-+-+-+-+-+-+-+-+-+-+-+-+-+-+-+-+-+-+-+-+-+-+-+-+-+-+-+-+-+-+-+-+-+-+-+-+-+-+-+-+-+-+-+-+-+-+-+-+-+-+
