+-+-+-+-+-+-+-+-+-+-+-+-+-+-+-+-+-+-+-+-+-+-+-+-+-+-+-+-+-+-+-+-+-+-+-+-+-+-+-+-+-+-+-+-+-+-+-+-+-+-+
| | | |   |     | | |   | |   |       | |   |   | | | | |     |     | |             | |     | |   | |
+ + + + +-+ + +-+ + + +-+ + +-+-+ + +-+ +-+ + +-+ + + + +-+ +-+ +-+-+ +-+ +-+ +-+-+-+ +-+-+ + + +-+ +
|   |   | | |     | |   |   | | | |   |   |   | |     | | | | | | |   |   | | |       |   | |     | |
+ +-+-+ + +-+-+ +-+ +-+ + +-+ + +-+-+ + +-+-+ + + + +-+ + + + + + +-+ + +-+ + + +-+-+-+ +-+ + +-+-+ +
| | |       |   |             |   |   |       | | | |   | | |   |     | | | |   |       | | |   | | |
+ + +-+-+ +-+ +-+ +-+ + + +-+-+ +-+-+ + + + +-+ + +-+ +-+ + + +-+ + +-+ + + +-+ +-+-+ +-+ + + +-+ + +
|   | | | | | | | |   | |   |   |       | |   | | |   |       |   | |   |     |             | |     |
+-+ + + + + + + +-+-+ +-+ +-+-+ +-+-+-+-+ + +-+ + +-+ +-+ + +-+ +-+-+ +-+ + +-+-+-+-+-+ + +-+ +-+-+ +
| |       |   | |   | |   | |   |       | | |     |   | | |           | | | | |   |     |     |     |
+ +-+ + +-+ +-+ + +-+ + +-+ +-+ +-+ + +-+-+ +-+-+ + +-+ + +-+ + +-+ +-+ + +-+ +-+ +-+-+ + +-+-+ +-+-+
|     |   | | |     | | |   | |   | | | | |       | |   |   | | |         |           | |   | | | | |
+ + +-+ +-+ + + + +-+-+ +-+ + +-+ +-+ + + +-+ + +-+ + +-+ +-+-+-+-+ + + +-+-+ +-+-+-+-+-+ +-+ + + + +
| | | | |       | | |   | |   |   | | |   | | |     | |     | |     | |         | | | | |   | | | | |
+ +-+ + + +-+ +-+-+ + +-+ +-+ + +-+ + +-+ + +-+ +-+-+ + + +-+ +-+-+-+ + +-+-+ +-+ + + + +-+ + + + + +
| |         |         | | | |   |     | |     |     | | | | | |     | | | |           |       | |   |
+ + +-+-+ + +-+-+ +-+-+ + + + +-+ + +-+ + + +-+-+-+ + + +-+ + +-+ +-+ +-+ + +-+-+-+-+ + +-+ +-+ +-+ +
| |   | | |     | |   |   |   |   | |     | |     | | | | | | |     | | | | | |   | | |   | |       |
+-+-+ + + + + +-+-+-+ +-+ +-+ +-+-+ +-+-+ +-+ + +-+ + + + + + +-+ +-+ + + + + + +-+ +-+ +-+-+ + +-+-+
|   | |   | |         | | | |   | |   |   |   | |   |     |       |     |   |   |   | |   |   | | | |
+ +-+-+-+-+-+-+-+ +-+-+ + + +-+ + +-+ +-+ + + +-+-+ + +-+-+ + + +-+ +-+ +-+-+-+ +-+ + + +-+-+ +-+ + +
| | | | | |   | |     |   |   |       | | | |     |     |   | | | | | | | | |     |     | | | |     |
+ + + + + + +-+ +-+-+ + +-+-+ + + + +-+ + + +-+-+-+-+ +-+-+-+ +-+ + + + + + + + +-+ + +-+ + + +-+ +-+
| |   | |   | | |     | |   |   | | |   | |   |   |   |   |   | | | |   | |   |   | |   | | | |   | |
+ + +-+ + +-+ + +-+-+ + + +-+ +-+-+-+ +-+ + +-+-+ +-+ + +-+ +-+ + + + +-+ +-+ + +-+-+-+ + + + +-+ + +
|   |   | |   |   | | | | |     |     |         |     | |   | |   | |         |   |           | | | |
+-+ + +-+ +-+ + +-+ + + + + + +-+-+ +-+-+ + +-+-+ + +-+ +-+ + +-+ +-+-+ + + +-+ +-+-+-+ + + +-+ + + +
|           | |         |   | |   | |   | | | |   |             | | | | | | |       |   | | |   | | |
+ + +-+ +-+-+ +-+-+-+ +-+ +-+-+-+ + +-+ + +-+ +-+ +-+-+ + +-+ +-+ + + +-+ + +-+-+ + + + + +-+-+ + + +
| |   | | | | |             |   | | | |   |   | | | | | | | |       |     | |     | | | |   |   |   |
+-+-+ +-+ + + + + + + +-+ +-+-+ + + + +-+ + +-+ + + + + +-+ + +-+ + + +-+-+ + + +-+-+-+ +-+-+ +-+-+ +
| | | |       | | | | | |   | |         | | |   | | |   |   |   | | |     | | |       | | | |   | | |
+ + + + +-+ +-+-+ +-+-+ + +-+ +-+ +-+-+-+ + +-+ + + +-+ +-+ +-+-+-+ +-+-+ + + +-+ + + +-+ + + +-+ + +
|     | |     | |   | | | |   | |     | | | | |   |   |       | | | | | | | |   | | |   |           |
+-+-+ + + + +-+ +-+ + + + + +-+ + +-+-+ + + + + +-+ +-+-+ + +-+ + + + + + +-+-+-+-+-+-+-+-+-+-+ + +-+
|   | | | | |   | |     |           | | |               | |   | | | |       |         | | |     |   |
+-+ + + +-+-+-+ + + + + +-+ +-+-+-+-+ + +-+-+-+-+-+-+ + +-+-+-+ + +-+ + +-+-+-+ +-+ +-+ + + +-+-+ +-+
|     | | |     | | | |   | | |   | | |   | |   |   | | | | |     | | | |       |   |     | |       |
+ + +-+ + + +-+-+ +-+ +-+-+-+ +-+ + + +-+ + +-+ +-+ +-+ + + + +-+-+ +-+ + +-+-+ + +-+-+-+ +-+ +-+-+-+
| |       |           |     |     |   | | | |   |   | |   |       |   | | |     |   |         | |   |
+-+ +-+-+-+ + +-+-+ +-+-+ +-+-+ +-+ +-+ + + + +-+ +-+ +-+ + + +-+-+ +-+ +-+ + + +-+-+ +-+ + +-+ + +-+
|   |       | |     |     | | |     | | | |   |       | |   |     | | | |   | |   | |   | | |   | | |
+ +-+-+ +-+-+-+-+-+-+ +-+-+ + + +-+-+ + + + +-+ +-+-+-+ +-+-+-+-+ + + + +-+-+ + +-+ + + +-+-+ +-+ + +
| | | |   |     |     |     |   |   | | | |   | |   |   |   | | | | |         |     | | | | | |   | |
+ + + + +-+ + +-+ + +-+-+-+ + +-+ +-+ + + +-+ + + +-+-+ + +-+ + + + + +-+ + +-+ +-+-+ +-+ + + +-+ + +
| | | | | | | | | | |       |     |   |         | |   | |     |     | |   |   | | | | | |   |       |
+ + + + + +-+ + + +-+-+ +-+-+ +-+-+-+ + + + + +-+ + +-+ + +-+-+ +-+ +-+ + +-+ +-+ + + + + +-+ + +-+-+
|       |   | | | |     | | | | |     | | | | |   | | |     | | |   |   | |     |     |   |   | | | |
+ +-+-+-+-+ + + + + + +-+ + + + + +-+-+ + +-+-+-+ + + +-+-+ + +-+-+-+-+ +-+ +-+-+-+-+ + +-+ + +-+ + +
|   |   | |   | | | |     | |     |     | | |   |   |   | |           | |   | |   | |   |   |     | |
+-+ +-+ + + +-+ + +-+-+ +-+ + +-+-+ +-+-+-+ + +-+-+ + +-+ + + +-+ + +-+ + +-+ + +-+ + +-+ +-+-+ +-+ +
|     |       | |         |     |       |   | |       | |   | | | | |   | |       |       | | |   | |
+-+ +-+ + + +-+ +-+ + + +-+-+ +-+ +-+-+-+ +-+ +-+ + +-+ + +-+-+ +-+ +-+-+ + + +-+-+ +-+-+-+ + +-+ + +
| | |   | |         | | | |   |   | | | |       | |     | | | | |   | |   | | |       | |   |     | |
+ + +-+ +-+-+-+ + +-+-+-+ +-+ + +-+ + + +-+-+ +-+-+ + +-+ + + + +-+ + +-+ + +-+-+ +-+-+ + +-+ +-+-+ +
| | | |   | |   | | |       |       |   | | |     | | |   | |     |     |     | |   |   |     | | | |
+ + + +-+ + + +-+-+ +-+ + +-+ +-+ +-+ +-+ + +-+ +-+-+ + +-+ +-+ +-+ +-+-+-+-+ + + +-+-+ +-+ +-+ + + +
| | |     |   | |   |   | | | | |     |     |             | |   | | |     | |       | | | | | |   | |
+ + + +-+ + +-+ + +-+-+-+ + + + + +-+-+ + +-+-+ + +-+ +-+-+ + +-+ + + + +-+ + +-+-+-+ + + + + + +-+ +
| | |   | |     |   |   |   |   |       | |     |   | |   |   | | |   | | | |       | | |   |       |
+ + + +-+-+ + +-+-+ +-+ +-+ +-+-+ +-+ +-+-+-+ + + +-+-+-+ +-+ + + + + +-+ + +-+ + +-+ + + +-+ +-+-+-+
| | |   |   | | |     |   |     |   | | | | | | | | |     | |       |   |       |   |   |   | |     |
+ + + +-+ + +-+ +-+ +-+ +-+ + +-+-+-+ + + + + +-+-+ + +-+-+ +-+-+ +-+-+-+ + + + +-+-+ +-+ +-+ + +-+-+
| | |   | | |   | |   |   | | | |   |     |     |   |       | | |   | |   | | | | | | |     | | | | |
+ + +-+ + +-+ +-+ + +-+ +-+ +-+ +-+ +-+-+ +-+ +-+ +-+ + +-+-+ + +-+ + +-+-+-+ +-+ + + +-+ +-+ + + + +
| |   | |     |   |       | | |   | | | | |           | | | |   |               |   |   |     | |   |
+ + +-+-+ + +-+-+ + +-+ +-+ + +-+ + + + + +-+ +-+-+-+ +-+ + + +-+ +-+-+-+-+ + +-+-+ +-+ + + +-+ +-+ +
| | |     | |   | | | | | |           | |           | |     | |   | |   |   |       |   | | |       |
+ + +-+-+ +-+ +-+ + + + + +-+-+-+ + +-+ + + +-+-+-+ +-+ +-+-+ + +-+ +-+ +-+ +-+ +-+-+-+ +-+ +-+-+-+ +
|     |   |   | |     | | |   |   |     | |       | | |     |   |     | | | | |   | |         | | | |
+ + +-+ +-+ +-+ + +-+-+-+ + +-+-+ +-+ +-+-+-+-+ +-+-+ +-+-+ + +-+-+ +-+ + + + + +-+ +-+-+-+-+ + + + +
| | | | | |   |       |   | |   |   |           |   | | |     | |   | |   | |   |   | | | | |     | |
+ +-+ + + +-+ + +-+ +-+ +-+ + +-+-+-+ + + + + +-+-+ + + +-+-+ + + +-+ +-+ +-+ +-+-+ + + + + + + +-+ +
| |   |         |   | | | |   | | | | | | | |             | |     | |     |   |   |           |     |
+ +-+ +-+ +-+-+-+ +-+ + + + +-+ + + + + + +-+ +-+ + + +-+-+ +-+ +-+ + +-+-+-+ + +-+ + +-+ +-+-+-+-+-+
| | | | | |     | | | |         | |   | |   |   | | | |       |   | |     |     |   |   |       |   |
+ + + + + + + +-+ + + +-+ +-+-+-+ + +-+ +-+-+-+ + +-+-+ +-+-+-+-+ + + +-+-+-+-+-+ + +-+-+ +-+-+-+-+ +
|   |   |   | | | |   |   |         | | | | | | |     |   |     |   | |   |     | | | | |     | | | |
+ +-+-+ +-+-+ + + + +-+-+ +-+-+-+-+ + + + + + + +-+ +-+-+ +-+ +-+-+ + +-+ +-+ +-+-+ + + + + +-+ + + +
| | | |     |   |     | |     | |   | | | | | | |   |         |     |   |         |     | | | |   | |
+ + + + +-+-+-+ +-+-+-+ + + +-+ + +-+ + + + + +-+-+ +-+ + + +-+-+-+ + +-+ +-+ +-+-+ +-+ + +-+ + +-+ +
|     |     |   |   | | | |   | | |       |   |       | | | |       | |     |   |   | | | | | | | | |
+-+-+ +-+-+ + +-+ +-+ + +-+-+ + + + + + +-+ +-+-+-+-+ + + +-+-+-+-+ + + +-+ +-+-+ +-+ +-+ + + + + + +
| |   | | |   | | |   |       | | | | |   | |   |   | | |           |   |     |   |       |   |     |
+ +-+ + + + +-+ + +-+ + +-+ +-+ + + + + +-+ + +-+ +-+-+-+-+-+ +-+-+-+-+ + + +-+-+ +-+-+-+-+-+ +-+ +-+
| |           |   | | |   | | | | | | |     |       | |     | | | | |   | |       |   |   | |   | | |
+ + +-+-+-+ +-+-+ + + + +-+-+ + +-+-+ + + +-+ + + +-+ +-+ +-+ + + + + + + +-+ +-+-+-+ +-+ + +-+ + + +
| |   | |   | |               | | | | | | | | | | |       |   | |     | | |   | | |   | |       |   |
+ +-+ + + +-+ + + + + + + + +-+ + + +-+-+ + +-+ +-+ + + +-+-+ + +-+-+-+-+-+-+ + + +-+ + + +-+ +-+-+ +
| |     | | |   | | | | | |     | |   |     | |     | |           | |   |   |     | |   | | | |   | |
+ +-+-+-+ + + +-+ + + +-+ +-+-+-+ +-+ +-+-+ + +-+ +-+ + + + + + +-+ +-+ +-+ + +-+-+ +-+ + + + +-+ + +
| | |     |   |   | | | | | | |   | |   | |     |   | | | | | | |   | |     |   | |         | |     |
+ + +-+-+ + +-+-+-+ +-+ + + + + +-+ +-+ + + + + +-+ + + + + +-+-+ +-+ + + +-+ +-+ + + +-+ +-+-+-+-+ +
|   | |   |       | |   |   |   |   | | |   | |   | | | | |   | |     | | | | | |   | |   | | | | | |
+-+ + + +-+-+ +-+ +-+-+ + +-+-+ +-+ + + +-+ + + + + +-+ + +-+-+ + + +-+ +-+ + + +-+ +-+ +-+ + + + + +
|   |     | | |   |     |     | | |   |   | | | | |   | | | | |   |   | |     |   |   |             |
+-+ + +-+-+ +-+ +-+ +-+-+ + +-+ + +-+ + +-+-+-+ +-+-+ +-+-+ + +-+-+-+ + +-+-+ +-+ +-+ + + +-+ +-+ +-+
| |     | |         |   | |     | |   |         |   |   |   |   |   |     | | |   | | | | | |   |   |
+ +-+-+ + +-+-+ +-+-+ +-+-+-+-+ + +-+ + + + +-+-+-+ + +-+ +-+-+ +-+ +-+-+ + + + +-+ +-+ +-+ + +-+ +-+
|     |     |   | |   | |     | | | | | | | |   | |   |       |   |   | | | |   | |       | | | |   |
+-+-+ + +-+-+ +-+ +-+ + + +-+-+ + + + +-+-+ + +-+ +-+ + +-+-+-+-+ +-+ + + + + +-+ + +-+-+-+ + + + +-+
|     | |   | |     |       |   | |   |         | | |     |   |   | |   | |     | |         | |   | |
+ + +-+ + +-+ + + +-+ + + +-+ +-+ +-+ +-+ + +-+-+ + + + +-+-+ +-+ + + +-+ +-+-+ + + +-+-+-+ + + +-+ +
| |   |         | | | | | |           | | |         | | |   | | | | | | |           | | | | | |   | |
+ +-+-+ +-+-+ +-+-+ + + +-+-+ + + + +-+ + + + + + + +-+-+-+ + + + + + + + + + + + +-+ + + + +-+-+-+ +
|       | |   | | |   | |   | | | |   |   | | | | | | | |     | | |     | | | | | |   |   |   |     |
+ + +-+-+ + +-+ + +-+-+ + +-+-+-+ + +-+-+ + +-+ + +-+ + +-+ +-+ + +-+ +-+ +-+-+ +-+ +-+ +-+ +-+ +-+-+
| | | |   | |           | |   |   |     | |   | | | |   | |     | | |   |   |     | | |             |
+ +-+ +-+ + +-+-+-+-+ +-+ +-+ + + + +-+-+-+ + + +-+ +-+ + + +-+-+ + +-+ + + +-+ +-+ + +-+ + + + +-+-+
| | |           | | |     |   | | |   | |   | | |   | |     |   |   |   | | | |       |   | | |   | |
+ + +-+-+-+-+-+ + + +-+-+ + +-+ + +-+-+ + + + +-+-+ + + +-+-+ +-+-+ +-+ +-+ + +-+ +-+ +-+ + +-+ +-+ +
|   |   | | | |       |   |   | | | |     | | |       |   |     |   |         |     |   | | | |     |
+-+ +-+ + + + +-+ +-+-+ +-+-+ +-+ + +-+-+ + +-+ +-+-+-+-+ +-+ +-+-+ + +-+-+ +-+ +-+ +-+ +-+-+ + + +-+
| |   | | |         | | | | |   |     |   |     |         | | | | | | |   |   | |   | |       | |   |
+ +-+ + + + +-+ + +-+ + + + +-+ + +-+-+-+-+-+ +-+ +-+ + +-+ + + + + + +-+ +-+ + + +-+ +-+-+ + + + +-+
|   | | | | |   |       | |   | | |   | |     | | |   | | | | |         |     | | | |       | | |   |
+ +-+ + + +-+-+ + + +-+-+ + +-+ + +-+ + + + +-+ + + +-+-+ + + + + +-+ + + +-+-+ +-+ +-+-+ +-+ + +-+-+
| | | | | |   | | | | | |       |         | | |   |     |     | |   | | | |     |   |       | |     |
+ + + + + +-+ + +-+-+ + + + +-+-+ +-+-+-+-+-+ +-+ + + +-+-+-+ +-+-+-+-+ + + +-+-+ +-+-+-+ + + + +-+-+
| | |   |     | | |       | |   |     |   |   |   | |   |   |   |   | | | |             | | | |     |
+ + +-+ +-+-+ + + + +-+-+-+-+ +-+-+ +-+-+ +-+ +-+ + +-+-+-+ + +-+-+ + +-+-+-+ + + +-+-+-+ + + +-+-+-+
| |   | |       |     | | |   |           | | | | |       | |   | | | |     | | | | |     | | | |   |
+ + +-+-+-+-+ +-+ + +-+ + + +-+ +-+ +-+ +-+ + + + + + +-+-+ + +-+ + + +-+ +-+-+ +-+ +-+-+ +-+-+ + +-+
| |       | |     |   | |     | | |   |       | | | |     | |   |   | |       |       |       | |   |
+ +-+-+ +-+ +-+ +-+-+-+ +-+ +-+ + + +-+ +-+ +-+ +-+-+ + +-+ + +-+-+ + + + +-+-+-+ + + +-+ + +-+ +-+ +
|   |             | | |           | | |   | |   | |   |     | | |   | | |         | | |   | | |   | |
+ +-+-+ +-+-+ +-+-+ + + +-+ + +-+-+-+ +-+-+ +-+ + +-+-+ +-+-+ + +-+ + + + +-+-+ + +-+ +-+ +-+ +-+ + +
|   | |   | | | |     |   | |   |   |     |   | |   |   | |         | | | |   | | |   | | | |       |
+ +-+ + +-+ + + +-+-+ +-+ +-+-+-+ +-+-+ +-+ +-+ +-+ +-+ + +-+-+-+-+ + +-+ +-+ + +-+-+-+ + + +-+-+-+ +
| | | | |               |     |           |     |     |   | |   |   | |       | |   | | |     | | | |
+ + + + +-+-+ + + +-+ + +-+-+-+ +-+-+ + +-+-+-+ +-+ +-+ +-+ + +-+-+ + +-+ +-+ +-+-+ + + +-+-+ + + + +
|   | |     | | |   | | |   |       | | | |   |     | | |         |     | |     |   |   |       | | |
+-+ + + +-+ + +-+-+ +-+-+-+ +-+ + +-+ +-+ + +-+ + +-+ + + +-+ + +-+ + +-+-+ +-+-+ +-+-+ + +-+-+-+ + +
| | |     | | |   | | | |     | | | |   |       | | | |   |   | | | | | |   |   |     |   | |       |
+ + +-+-+-+ +-+-+ + + + + + +-+ +-+ +-+ + + + + +-+ + +-+ +-+-+-+ +-+ + + +-+-+ + + +-+ +-+ +-+ +-+-+
| |   | |   | |     | | | |   | | |       | | |         | | | |   |   |     |   | | |           | | |
+ +-+ + +-+ + +-+ +-+ + + + +-+ + +-+ + + + + + + +-+-+-+ + + + +-+-+ + +-+-+-+ +-+ +-+-+ + +-+-+ + +
| | | | | | | | |   | | | |   | | |   | | | | | |   |   |   | |   | | |     |   | |   | | | | |   | |
+ + + + + + + + + +-+ + +-+ +-+ + + +-+ +-+ + +-+-+-+-+ +-+ + +-+ + + +-+ +-+ +-+ +-+ + +-+ + +-+ + +
| | | | |     |         |   |     |   | |   |   |     |       |   |     |       |     |   | | |   | |
+ + + + +-+-+-+ + +-+-+-+ +-+-+ +-+-+-+-+-+ + +-+-+-+ + + + +-+-+ +-+ +-+ + + +-+-+-+ + +-+ + +-+ + +
| |     |       | | |   | |   |     | | |   |   | | | | | |     |     |   | | |     | | | | | | |   |
+ + +-+-+-+-+-+-+ + +-+ + + +-+ + +-+ + + + + +-+ + + +-+ + + +-+-+ +-+ +-+-+-+-+-+ + + + + + + +-+ +
|   | |   |   | | |   | |   | | | |       | | | | |   |   | | |           | | |   |         |   | | |
+ +-+ +-+ +-+ + + + +-+ + +-+ +-+ +-+-+-+-+-+-+ + + +-+ + +-+-+ + +-+ + +-+ + + +-+ +-+-+-+-+-+ + + +
|   | |     |   |         | | | |         | |       |   | | |   | |   |   | |   | |                 |
+ +-+ +-+-+ + +-+ + + +-+-+ + + +-+ +-+ +-+ + +-+ +-+ +-+-+ +-+ +-+ + +-+-+ + +-+ +-+-+-+ + + +-+ +-+
|     | | |   | | | | | | |   |   | |         |   |     | |       | | | | | | | |   | | | | | | |   |
+-+ +-+ + +-+ + + + +-+ + + +-+-+ +-+-+ +-+ + +-+-+ +-+-+ + +-+-+ +-+-+ + + + + +-+ + + + +-+-+ + +-+
|                 |   | | | | | | | |     | | |           | |     | | |   |       | | |   | |   |   |
+ +-+-+-+-+ + + + +-+-+ + + + + + + + + + +-+-+ +-+-+ +-+-+ +-+ +-+ + + +-+-+ +-+-+ + +-+ + + +-+-+ +
| | |   |   | | | | | |       | | |   | | | |   |         | |                 |   | |     | | | | | |
+ + + +-+ +-+ + +-+ + +-+-+-+ + + + + + +-+ + +-+-+-+ + +-+ +-+ +-+ + +-+-+-+-+-+ + +-+ +-+ + + + + +
| | | | | |   |   |       | | | |   | |     | |     | | |     | |   |   | | | | | | |     | | |   | |
+ + + + + + +-+-+-+-+ +-+-+ + + + +-+-+ +-+-+ + +-+-+-+ +-+-+-+ +-+-+ +-+ + + + + + +-+-+ + + + +-+ +
|   |     |   | |   | |   |   | |   |   | |   | | |   | |   |   |               | | |   |   | | | | |
+ +-+-+ +-+ +-+ + +-+ +-+ + +-+ + + +-+-+ +-+ + + + +-+ + +-+-+-+-+ +-+-+ +-+-+-+ + +-+ +-+ + + + + +
|   | |   | | |         | |       | |   |     | |     |   | |   | | |   |     | | |   | |     |   | |
+ +-+ + + +-+ +-+ + +-+-+ +-+ + +-+-+ +-+ +-+-+ + + +-+ +-+ +-+ + + + +-+ +-+-+ + + +-+ + +-+-+ +-+ +
|     | |         |         | |                   |   |           |     |               |         | |
+-+-+-+-+-+-+-+-+-+-+-+-+-+-+-+-+-+-+-+-+-+-+-+-+-+-+-+-+-+-+-+-+-+-+-+-+-+-+-+-+-+-+-+-+-+-+-+-+-+-+
