+-+-+-+-+-+
| | |     |
+ + + + +-+
|     |   |
+ + + +-+-+
| | | |   |
+ +-+-+-+ +
|   | |   |
+ +-+ +-+ +
|         |
+-+-+-+-+-+
