+-+-+-+-+-+-+-+-+-+-+-+-+-+-+-+
|               |             |
+-+-+ + + + +-+-+ +-+-+-+ +-+-+
| |   | | | | |       | | | | |
+ +-+ + + +-+ + + +-+-+ + + + +
|     | |   |   |     |     | |
+-+ + + + +-+ +-+-+-+ +-+-+-+ +
|   | | |   | | |       |   | |
+-+-+ + +-+-+ + +-+-+ +-+-+ + +
|   | | | |   | |         | | |
+ +-+ +-+ +-+ + +-+-+ +-+-+ + +
|   |       | | |     | |   | |
+ +-+-+ + +-+ + + +-+-+ +-+ + +
| |   | | | |   | | | |   | | |
+ +-+ + +-+ +-+-+ + + + +-+ + +
| |   | | |         | | | |   |
+ + +-+ + + + + + +-+ + + +-+ +
|   |   | | | | |   |         |
+ +-+-+ + + +-+-+ +-+ + +-+ +-+
| |       |   |   |   | | | | |
+ + +-+ +-+ +-+ +-+-+ +-+ + + +
| |   | | |   |       | |     |
+ +-+-+ + + + +-+-+ +-+ + +-+-+
| |     |   |   | |     | | | |
+ +-+ +-+-+ +-+-+ + + + +-+ + +
| | |   |   | |     | | | |   |
+ + + +-+ +-+ +-+-+-+-+ + +-+ +
| | |   | | | |   |           |
+ + +-+ + + + + +-+ +-+-+-+-+-+
|                 |           |
+-+-+-+-+-+-+-+-+-+-+-+-+-+-+-+
