+-+-+-+-+-+-+-+-+-+-+
| |   |   | | |     |
+ +-+ + +-+ + +-+ +-+
| |   |   |   | | | |
+ +-+ + +-+-+ + + + +
|   | | |     | |   |
+ +-+ + +-+-+ + + +-+
|           |   | | |
+-+-+ + +-+-+-+ + + +
|     | | | | | |   |
+ + +-+-+ + + + + +-+
| | | |   | | |     |
+-+ + +-+ + + +-+-+ +
| | |   |     |     |
+ + +-+ + + +-+-+-+ +
| |     | | |       |
+ + + +-+-+ + +-+-+-+
|   | | |   |     | |
+ + +-+ + +-+-+ +-+ +
| |                 |
+-+-+-+-+-+-+-+-+-+-+
