+-+-+-+-+-+-+-+-+-+-+-+-+-+-+-+-+-+-+-+-+
|       |   |       | |   |             |
+-+-+-+ +-+ + +-+ +-+ + +-+ +-+ + + +-+-+
| |     | | |   | | | | |   | | | |     |
+ + + +-+ + +-+ +-+ + + + +-+ + +-+-+ +-+
|   | | | |   | | | | |   |       | | | |
+-+-+ + + + +-+ + + + + + +-+ +-+-+ + + +
| |   | | |     |   | | |   |   |   |   |
+ + +-+ + + +-+-+ +-+ + +-+ + +-+-+ +-+ +
| | | |   |           |   | | | |   |   |
+ + + +-+ + + + +-+ +-+ + +-+-+ + +-+-+ +
| |     | | | |   |   | | |       |   | |
+ +-+-+ + + +-+ + +-+-+ +-+-+-+-+ + +-+ +
| | |   | | |   |   | | |   |   |     | |
+ + + +-+ +-+-+ +-+-+ + + +-+-+ +-+-+ + +
|     | |           |   | |       | | | |
+ +-+-+ +-+ +-+-+-+-+-+ + + +-+ +-+ + + +
| |   | | |       |         |   |       |
+ + +-+ + +-+ + +-+ + + + + + +-+-+ + +-+
| |           | | | | | | | | |     | | |
+ +-+-+-+ + + +-+ +-+-+ + + +-+ +-+ +-+ +
|     | | | |   | |     | |   |   |     |
+-+-+ + +-+ +-+-+ +-+-+ + +-+ +-+-+-+ +-+
|     | | |   |     | | | |         | | |
+ + +-+ + + +-+-+ +-+ + + +-+-+ + +-+-+ +
| |   |   | |   |     | | | | | | |   | |
+ +-+-+-+ + + +-+ + +-+ +-+ + +-+ +-+ + +
| |   |   | |   | |     | | | | | | | | |
+ +-+ + +-+ + +-+-+-+-+ + + + + + + + + +
| |       | | |     | |         | |     |
+ + + + +-+ + + + +-+ +-+ + + +-+-+-+ +-+
| | | | |   | | |   | | | | |   |   |   |
+ +-+ +-+-+ + + +-+-+ + + +-+-+-+-+ + +-+
| |           | |     |     |       | | |
+ + + + +-+ +-+ +-+-+ +-+ +-+-+-+-+ + + +
| | | |   |       | |   |       |     | |
+ +-+ +-+ +-+ + +-+ +-+ +-+ +-+-+ +-+-+ +
|     | |   | | |     | |         | | | |
+-+-+ + + +-+ +-+ +-+-+ +-+ +-+-+-+ + + +
|       |   |                           |
+-+-+-+-+-+-+-+-+-+-+-+-+-+-+-+-+-+-+-+-+
